#########
#X....#X#
#####.#.#
#@......#
#########