###############
#.........#...#
#.#####.###.#.#
#@#.........#.#
#####.#####.###
#...###...#.#.#
###.#.#.#.###.#
#.#.#...#...#.#
#.#.#.#######.#
#.....#...#...#
#.#.#.#.###.#.#
#.#.#.......#.#
#.#.#########.#
#.#....X#.....#
###############