###############################
#@.......#........#...........#
####..#######..#############..#
#........#...........#........#
#######..#..#..#..##########..#
#........#..#..#..#..#........#
#..#..####..#######..####..####
#..#.....#...........#.....#..#
#..#..#############..####..#..#
#..#..#..#..#.................#
#..####..#..#..#############..#
#.....#.....#.....#.....#.....#
####..#..####..####..##########
#..........................#..#
#..#######..#######..####..#..#
#........#..#..#........#.....#
#..####..####..#..##########..#
#..#.....#.....#..#.....#..#..#
#..#..####..#..#..####..#..####
#..#........#..#.............X#
###############################